tape=tape.lib
displib=displib.lib
storport_dsf=storport_dsf.lib
tdi=tdi.lib
DSFStorage=DSFStorage.lib
battc=battc.lib
WMBBCLASS=WMBBCLASS.lib
srvnet=srvnet.lib
dxg=dxg.lib
bdl=bdl.lib
SoftFCKernel=SoftFCKernel.lib
rdbss=rdbss.lib
hwpolicy=hwpolicy.lib
crashdmp=crashdmp.lib
ataport=ataport.lib
csr_vfp_avdtp=csr_vfp_avdtp.lib
fwpkclnt=fwpkclnt.lib
armppm=armppm.lib
usbport=usbport.lib
wdf=wdfldr.lib
videoprt=videoprt.lib
smclib=smclib.lib
RNDISMP=RNDISMP.lib
tbs=tbs.lib
msnfsflt=msnfsflt.lib
hidclass=hidclass.lib
winhv=winhv.lib
scsiport=scsiport.lib
msrpc=msrpc.lib
msnfsflt=msnfsflt.lib
ipmidrv_hrmcust=ipmidrv_hrmcust.lib
storvsp=storvsp.lib
ndis=ndis.lib
ndistapi=ndistapi.lib
Saha=Saha.lib
ks=ks.lib
Soft1667FaultInjectionLimpetPool=Soft1667FaultInjectionLimpetPool.lib
stream=stream.lib
tcpip=tcpip.lib
SoftStorageLimpetPool=SoftStorageLimpetPool.lib
termdd=termdd.lib
parallel=parallel.lib
diskdump=diskdump.lib
USBPORT_DSF=USBPORT_DSF.lib
BdaSup=BdaSup.lib
mpio=mpio.lib
mcd=mcd.lib
FsDepends=FsDepends.lib
irt30=irt30.lib
drmk=drmk.lib
cng=cng.lib
wmilib=wmilib.lib
SoftSATAKernel=SoftSATAKernel.lib
rpcxdr=rpcxdr.lib
ksmartcpu=ksmartcpu.lib
vwififlt=vwififlt.lib
pciidex=pciidex.lib
bthport=bthport.lib
netio=netio.lib
storport=storport.lib
btampm=btampm.lib
FS=fltMgr.lib
dumpfve=dumpfve.lib
USBCAMD2=USBCAMD2.lib
USBCAMD=USBCAMD.lib
clfs=clfs.lib
dxgkrnl=dxgkrnl.lib
dxgmms1=dxgmms1.lib
mrxsmb=mrxsmb.lib
BTHPRINT=BTHPRINT.lib
mup=mup.lib
dxapi=dxapi.lib
wdftester=wdftester.lib
usbrpm=usbrpm.lib
portcls=portcls.lib
ntasn1k=ntasn1k.lib
1394bus=1394bus.lib
acpi=acpi.lib
protogon=protogon.lib
SoftFCLimpetPool=SoftFCLimpetPool.lib
RNDISMPX=RNDISMPX.lib
hidparse=hidparse.lib
win32k=win32k.lib
dumpata=dumpata.lib
classpnp=classpnp.lib
RNDISMP6=RNDISMP6.lib
watchdog=watchdog.lib
